10
20
20
xxxxxxxxxxxxxxxxxxxx
x.........x........x
x.........x........x
x.............xxxx.x
xxxxxxx...x...x....x
x..x......x...x....x
x..x......xxxxxxxxxx
x..x...............x
x..xx..............x
x...x......xxxxxxxxx
x...x.....xx.......x
xxx.x.....x..xxxx..x
x...x.....x.xx..xx.x
x...x.....x.x....x.x
x.xxx.....x.xx...x.x
x.........x.....xx.x
x.........xxxxxxx..x
x..................x
x..................x
xxxxxxxxxxxxxxxxxxxx